maibec	bold_red
syrah	bold_red
mourvedre	bold_red
pinotage	bold_red
petite_sirah	bold_red
touriga_nacional	bold_red
cabernet_sauvignon	bold_red
bordeaux_blend	bold_red
meritage	bold_red
meriot	medium_red
sangiovese	medium_red
zinfandel	medium_red
cabernet_franc	medium_red
tempranillo	medium_red
nebbiolo	medium_red
barbera	medium_red
cotes_du_rhone_blend	medium_red
pinot_noir	light_red
grenache	light_red
gamay	light_red
st._laurent	light_red
carignan	light_red
counoise	light_red
provencal_rose	rose
white_zinfandel	rose
loire_valley_rose	rose
pinot_noir_rose	rose
garnacha_rosadp	rose
bandol_rose	rose
tempranillio_rose	rose
saignee_method_rose	rose
chardonnay	rich_white
semillon	rich_white
viognier	rich_white
marsanne	rich_white
roussanne	rich_white
sauvignon_blanc	light_white
albarino	light_white
pinot_blanc	light_white
vermentino	light_white
melon_de_bourgogne	light_white
gargenega	light_white
trebbiano	light_white
pinot_gris	light_white
pinot_grigio	light_white
champagne	sparkling
prosecco	sparkling
cremant	sparkling
cava	sparkling
metodo_classico	sparkling
sparkling_wine	sparkling
sparkling_rose	sparkling
moscato	sweet_white
riesling	sweet_white
chenin_blanc	sweet_white
gewurztraminer	sweet_white
late_harvest_whites	sweet_white
alsacian_pinot_gris	sweet_white
port	dessert
sherry	dessert
madeira	dessert
vin_santo	dessert
muscat	dessert
pedro_ximenez	dessert